type octile
height 52
width 52
map
@@@@@@@@............................................
@@@@@@@@.@@@@@@@.@@@@@@@@@@.@@@@@@@@@@@@@@@@@@@@@@@@
@@@@@@@@.@@@..............@.@............@@@@@@@@@@@
.........@@...............@.@.@@@@@@@@@@............
.@@@@@@@@@................@.@.@@@@.....@@@@@@@@@@@@.
.@...............@..@@@@..@.@.@...................@.
.@.............@@@..@@@@@@@.@.@@@@.....@.@@@@@@@.@@.
.@@@@@@@.@@@@@@@.@..@@@@..@.@.@@@@@@@@@@..@@@@@...@.
.@.............@..........@...@........@......@...@.
.@.@@@@@.@@@@@.@........@@@@@@@.@@@@@@.@@@@.@@@...@.
.@.............@.@@@............@....@............@.
.@@@@@@@.@@@@@@@........@@@@@@@.@.@@.@.@@@@@@@@...@.
......@.................@.....@.@..@.@.@.@@@..@...@.
.@@@@@@.............@@@.........@..@...@..........@.
.@.@@@@.................@.....@.@..@.@.@......@...@.
.@....@.................@@@@@@@.@.@@.@.@@..@@@@...@.
.@....@.........................@....@.@.....@@...@.
.@@@@.@.................@@@@@@@.@@@@@@.@..........@.
.@......................@@@@@@@...........@@@@..@@@.
.@.......@@@@@..........@@@@@@@@@@..@@@@..@@......@.
.@......................@@@@@@@........@..@@......@.
.@......................@@@@@@@........@..........@.
.@.@@@@@.@@@@@..........@@@@@@@........@..@@..@...@.
.@......................@@@@@@@...@@......@@..@...@.
.@@@@@@@@@@@@@@@........@@@@@@@...@@......@@..@...@.
.@.@@@@@.@@@@@......@@@............@...@......@...@.
.@.....................................@..@@..@...@.
.@.......................@@@@@.........@..@@..@...@.
.@.......@@@@@...@@@....@@@@@@@........@..@@..@...@.
.@......................@@@@@@@@@@..@@@@......@...@.
.@......................@@@@@@@@@@..@@@@@@@@@@@...@.
.@....@.@...............@@@@@@@........@@@@@@@@...@.
.@....@.@...............@@@@@@@...................@.
.@@@@@@@@@@@..@@........@@@@@@@...................@.
..........@....@@................@@@...@@@@@@@@@@@@.
@@@@@@@@@...............@@@@@@@........@............
@.........@....@@@......@.....@..........@@@@@@@@@@.
@.@@@@@@@@@....@.......@@.....@........@............
@.@@@@@@.......@@@.....@@.....@..@@@...@@@@@@@@@@@@.
@.@@..........................@............@@@@@@.@.
@.@@...................@@.....@...................@.
@.@@@..........@.......@@.....@............@@@@@@.@.
@.@@@..........@........@@@@@@@............@@@@@@.@.
@.@@@@@@@..@@@@@........@@@@@@@...................@.
@....@.....@@@@@@.......@@@@@@@............@@@@@@.@.
@@@@.@@........@@..........................@@@@@@.@.
@@@@.@@.................@@@.@@@...................@.
@@@@.@@@................@.....@............@@@@@@.@.
@@@@.@@@.......@@.@@@...@.@@@.@..@@@.......@@@@@@.@.
@@@@.@@@@......@@@@@@@..@.@@@.@...................@.
@@@@.@@@@@@@@@@@@@@@@@@@@.@@@.@@@@@@@@@@@@@@@@@@@@@.
@@@@......................@@@.......................
